early	except	
chicken	lose	e-mail
journalist	mixture	switch
domestic	ask	shade
veteran	flight	mode
offense	size	poor
sir	adjustment	public
throw	assumption	coalition
emphasize		
Congress		
serve	actually	frame
curriculum	examination	tunnel
after	access	
right	attack	gap
pursue	kitchen	
pet	deep	
blanket	athletic	encounter
take	often	brief
gas		
teaspoon	though	
loud	wear	journey
vehicle	invasion	south
honor	beginning	unit
barely	low	resolution
most	publicly	finish
daily	construct	participate
somebody		
track	partnership	studio
make	guide	sight
horror	focus	compose
bridge	theme	
characteristic	compete	beat
frequent		
hole	account	final
household	television	
ahead	vary	
daughter	know	while
present	feel	movement
screen	several	struggle
journal	iron	feed
body	fantasy	translate
her		
routine		
while	designer	
slave	water	
sentence	ocean	earnings
framework	majority	function
remaining		
twice	consensus	
be	else	teen
major	until	competitor
depend	tennis	
tomato	intervention	
from	display	
contribute		
club		
occupation	run	foundation
oil	fee	breathe
pitch	yourself	area
mention	leading	successful
choose		
fall	theater	dust
increasing	Islamic	fruit
wipe	construction	essentially
useful	existence	evolution
type	nothing	search
weekly	impose	viewer
nut	danger	
open	writer	candidate
across	stake	
attract	interested	ah
unless	clothes	access
contemporary	weather	quote
course		
history	barrel	
agreement	standing	diet
moreover	witness	cause
holiday	move	forest
dramatic	poor	
critic	asset	mind
green		
toss	Chinese	similar
animal		
well		
hardly	another	desire
later	thank	
fine		
lots	evening	date
rock	basic	answer
install	tomato	blow
establish	encourage	mix
interaction	name	naked
reform	damage	
remarkable		
western	close	lesson
golden	send	right
reflection		
permit	their	mortgage
up	stock	silver
response		
motion	advise	wipe
hang	housing	quick
pollution	terrorist	consequence
accomplish	commission	
appoint	panel	survival
double		
impressive	analyst	advertising
outcome	communicate	thanks
embrace	eventually	shot
often	ok	account
obviously	finish	headquarters
these	steel	
hip	bite	
first		
evidence		
assess	aspect	acid
borrow	subject	
digital	pound	only
membership	cookie	
election	retirement	writer
protect	reach	
blade	visit	
apple		
satellite		
collection	teaspoon	personally
terrorism	box	
party	statement	
selection	exercise	promise
significantly	one	professional
catch		
block		
roll	now	tend
bird	core	girlfriend
absorb	conduct	topic
buy	essay	achieve
universal	interesting	
propose	industrial	opportunity
would	Japanese	want
blind	ethics	AM
silence	immediate	possibly
profession	month	wall
consultant	bit	consumption
attention	dominate	farm
rule	mount	encourage
song		
church	doubt	grant
play	campaign	priest
flat	approximately	disability
income		
consume	mode	cheap
bite	hope	
raw	your	furniture
aircraft	tooth	generate
competitive		
taste	bother	partner
survive	day	love
ie	level	
resemble		
security	withdraw	therapy
figure	lucky	capacity
platform	ceremony	courage
receive	economic	model
map	sales	pie
remain	remind	era
volunteer	creative	
perceive	violence	approval
keep	personality	
intervention	customer	wind
generation	inflation	purpose
easy	collect	understanding
girl		
lost	mutual	
effective	switch	neighborhood
grandmother	teach	nerve
intention		
important	complex	parking
island		
window	demonstrate	extension
assault	Latin	versus
learning	decrease	violent
rare	school	
flow	yeah	
pot	lifetime	modest
physically	survive	absolute
ocean	difficult	
college	personally	listen
advise		
man		
formula		
dinner	prompt	
prospect		
physical	fail	consideration
crazy	ban	exhibit
bind		
software	accept	
explain	European	notice
cabinet		
ability	film	confusion
cap		
agency	connection	throat
studio		
ban	when	
works	outside	difficult
sequence		
project	nervous	
argument	circumstance	technology
surprised		
explanation	persuade	
information	head	demonstration
deer	organize	aside
who	buck	funny
expect	whisper	come
current	similar	affect
world		
perception	lay	strengthen
fix	relatively	
wish		
tablespoon	variety	decide
summer	recall	shore
advance	elementary	
opponent	bike	
its	running	text
surprisingly	pant	shrug
identity	complicated	cousin
sad	while	car
debt	welcome	clothing
executive	soldier	
ring	reference	pack
lift		
look	serious	
ourselves	besides	period
nerve		
estate		
myth	corporation	correct
wound	have	discuss
moon	accurate	previously
speaker	behavior	this
prominent	musician	restaurant
revolution		
presidential		
house	muscle	sentence
come	billion	craft
research	love	
argue	aircraft	prompt
sing	read	dear
heaven	competitor	honor
refuse	effective	
occasionally		
elect	study	
equal	following	table
calculate	increased	giant
movement	some	ring
might	length	
confusion	reform	father
opportunity	help	living
offer	broad	
component		
heart	count	science
winner	traffic	waste
diverse	block	technique
anymore	peer	murder
system	graduate	freeze
smell		
sweep	occasionally	constitute
dish		
constant	journey	burn
writer	leather	zone
weather	without	couple
rifle	voice	scientist
distinguish	rare	
entertainment	cousin	split
commander		
bright	criticism	mechanism
doctor	solution	
especially	thing	copy
venture	resemble	
wise	pregnant	sink
adapt	tragedy	
introduction	almost	motion
skill	taxpayer	blind
brain	cheap	fire
significance	violent	
e-mail	load	powder
discrimination	equal	
economic	full	
favor	profession	virus
woman	manner	assault
territory	grant	
bag		
solar	physically	clinical
Italian	undergo	
tomorrow	painter	travel
sex	method	note
date	song	extensive
text	valley	anxiety
case	mostly	sad
gang	disability	porch
favorite	action	
Senate	portion	squeeze
shift	tight	trip
disorder	headline	
barrier	Democrat	wave
offensive	yield	
radical	will	position
pilot	vessel	human
comprehensive		
policy	talk	find
wave	ever	pitch
drive	spiritual	
practice	cope	exhibition
native	afford	
cell	emotional	essential
growing	oppose	review
apparently	cake	kitchen
obligation	people	lose
coat	male	fee
Irish	lack	
administration	survivor	admire
possibility	basis	prime
child	lesson	green
passenger	equally	cotton
dining	concentrate	here
gate	financial	
curious	airline	anymore
governor		
name	like	
social	penalty	
Olympic	week	
imagination	crucial	
statement	new	
comfortable	laugh	
human	junior	beside
existing	testimony	stability
strike	turn	mood
violation	line	elect
change	hate	clothes
fat	poetry	crowd
worker		
marketing	husband	remaining
apartment	ring	
Mexican		
hate	hello	aware
dirty	artistic	road
loose	dispute	Mexican
victim	direct	cap
recruit	as	retire
unlikely	poet	
lawsuit	myth	establishment
clinical		
half	practical	
bake	opinion	salary
bet	producer	forward
intend	anniversary	low
literally	army	
bill		
much	capital	fresh
considerable	surgery	
hey	educate	great
diet	fighter	rural
significant	defense	influence
practical		
together	first	recall
participant	ghost	emission
boy		
thus	appropriate	from
ultimate	there	debate
limitation	absorb	
discovery	physical	faculty
cloud		
glad	mass	regardless
sharp	roof	
cry	valuable	
investigation	improve	head
AIDS	image	
cost	regard	recovery
stability		
campus	arrest	phase
slow	cancer	difference
salt	finally	dispute
cycle		
partner	proper	parent
select	sweet	
consistent	simply	early
build		
concentrate	twice	impose
stage		
toward		
loan	dozen	
approximately	group	shut
collapse	cream	stretch
visit	characterize	electricity
card	conflict	graduate
saving	deputy	
tiny		
tension	margin	scholar
exercise		
try	consciousness	
invite		
anger		
DNA	fourth	emphasize
mall	estate	
black	shall	colleague
working	salary	reduce
contrast	be	enterprise
airline	suspect	museum
distinct	roughly	because
afternoon	nevertheless	
signal		
scene		
planet	ill	
temporary	scene	session
influence	oh	
state		
ground	four	trade
evaluate	candidate	legacy
sudden	defendant	
tough	identify	economic
supposed	faculty	moderate
committee	recently	
heavily	language	
grow	them	
contain	explanation	
sweet	list	
fashion	clean	concerned
actual	frequency	
alcohol	remain	detailed
legacy	try	sound
museum	highlight	custom
contact	track	
soldier	yesterday	
snap	photograph	
access	resist	member
truck	native	lemon
total	legal	relatively
detailed	hi	knee
stay	pretty	
base	pursue	fish
quickly		
face	agenda	
little	department	mission
orange	type	tennis
discipline	towards	together
careful	recover	originally
style	temporary	environmental
adopt		
highly	search	soon
write		
disease	inner	mess
phase	proud	
via		
occur		
counselor	court	give
compose	conclusion	police
review		
place	revolution	recording
flight	importance	combination
bean		
limited		
panel	boundary	
blue	defeat	apartment
seed		
comedy	medical	
nearby	model	inflation
patch	economy	
briefly	fortune	towards
winter	fall	
force	teen	
ride	pipe	anyway
religion	hair	minute
psychologist	board	none
racial	participation	objective
entirely	out	able
pass	excellent	nevertheless
perform	courage	
driver	hell	rain
your	university	chair
opinion	someone	
son	hearing	
transportation		
Catholic	winner	container
tennis	most	severe
employee	sin	
adequate	tactic	spend
forget	series	particular
that		
everywhere	symbol	movie
plot	capture	
desert	tank	
lunch	couple	vehicle
differently	other	wealth
our		
coal	blanket	addition
farmer		
sample	capability	degree
trick	uncle	exact
married	dirt	brown
arm	probably	ie
arrange	increasing	besides
tall	gap	
sheet	segment	pop
computer		
injury		
Iraqi	police	trouble
global		
electricity		
script		
piece	sing	medical
occupy	historic	
sometimes		
latter	operate	crisis
connect	knee	spiritual
long-term	shine	really
shout	happy	
owner		
sell		
box		
admire	primarily	
warm	anybody	
self		
probably		
similar	assist	hate
flag	decision	fifth
scandal	estimate	
friendly	carbon	retain
incident	flesh	rare
touch	discover	
sort	its	
nevertheless	status	
finger	patient	cope
demand	finger	
grab	link	engineering
immigration	either	
meter	negative	complicated
report	ahead	package
chest		
adjustment	investigator	
aware	ball	Christmas
onto	kick	citizen
consensus	prayer	
dangerous	friend	utility
topic	those	
term	ability	hero
nose	divide	before
somewhere	careful	serve
activist	rarely	protect
fairly		
release	researcher	equal
recent		
lot	multiple	working
existence	foreign	
master	intense	carefully
fewer	team	list
tool	flow	choice
submit	store	drawing
Christian	test	world
object	negotiation	
efficiency		
prior	protein	
return	force	
brick	ago	which
again	comment	
cooperation	opposition	she
hell		
revenue		
wrong	thick	
violent	recent	painting
provision	expect	apparently
Canadian	enemy	
music	different	mention
mayor	brief	fix
portray	jump	
commit	bread	
terror	content	mean
mortgage		
squeeze		
sue	exactly	accompany
mix	maintenance	borrow
average		
shut	cop	
science	whose	
split	constantly	frequency
decrease	war	cultural
discover	dominant	employ
motor	expense	
agenda	local	
approve	doctor	worry
awful	drink	typically
colleague		
because	scientist	strange
preserve	fact	eat
pay		
ease	elect	soft
assign	laboratory	political
regional	target	
film	convention	counter
easily	unusual	
office	unique	
print	exchange	double
expression	president	
modest	smoke	hill
fifty	galaxy	reason
data	stone	speak
excellent	prosecutor	count
where	fitness	
including		
born		
buck	absolutely	
investigate		
brilliant	teacher	ultimate
many		
gifted		
mixture	deserve	speaker
shoe	murder	proud
pretty		
culture	site	regime
pray		
eager		
dig	knife	
fiction	plot	condition
spirit	fishing	effective
claim	lean	
interpretation	tale	dangerous
rough	motion	contribution
quarterback	journalist	boss
boyfriend		
check	bullet	make
stand	spin	clock
alternative	possibly	upper
test	dead	event
player	violate	solution
handle	prepare	promote
plenty	chemical	continued
effectively		
forever	preserve	trick
retirement	weekly	
strongly	enormous	
cabin	independent	
continue	true	
watch	publication	expense
news	tend	edition
extremely	loan	discover
develop		
debate	lock	
obvious	nut	absolutely
rope	stay	religion
Supreme	radical	gift
past	heavily	
insist	announce	
suddenly	resolve	continue
desperate	passenger	
rely		
voice	speaker	prove
decision	cut	
there		
resistance	defensive	impression
derive	emergency	consensus
available	branch	
wedding	great	online
he	breakfast	ought
protection	Olympic	behavior
chocolate	consultant	
cousin		
walk	data	
cake	fence	
giant	and	
moral	of	law
station	beauty	decade
everybody	pale	virtue
control	lie	
safe	rub	mine
float		
given		
recently		
ensure	together	simply
nature	rid	absence
creation	white	indicate
passion		
lady		
stuff	darkness	highway
freedom	fund	gang
widespread	wash	potentially
accompany	actress	reader
accurate		
earnings	trial	golf
lifestyle		
oh	whole	
prepare	seem	achievement
ceremony	bridge	
but	forward	
ever	eliminate	seriously
unable	color	approve
risk	asleep	
faculty	introduction	soccer
description	score	
cope	release	alone
helicopter	special	division
conventional	payment	town
dramatically	note	
prove	write	tiny
situation	philosophy	
own	reservation	dirt
least	loss	born
gather	controversy	contribute
visitor	ancient	joy
down		
educator	era	gray
letter	wealth	
supply	shadow	organize
whether	standard	
industrial	answer	collect
shelf	join	recruit
size		
price	usually	
heat	dare	few
we	arm	
dear	official	summit
kill	property	
commitment	five	wrap
telephone	discussion	
standard	differ	
thousand		
sister	incentive	its
death	father	formation
wood		
charity	sea	
recommendation	abortion	knife
speak		
beer	mirror	hold
knowledge		
suggestion	smooth	kiss
grave	recording	research
extend	gene	remember
administrator	case	start
building	negotiate	poet
direction		
purchase	consist	brother
opening	killer	others
so-called	metal	
fate		
perfect		
healthy	honey	changing
construction	parent	blue
appeal	setting	tribe
put	say	song
battle		
credit	ship	publicly
impose	acid	instance
hospital	fat	
and	tablespoon	hall
oven		
lawn	no	response
big	planning	deep
collective	angle	hair
training		
protest	aggressive	
joy	evidence	
center	phone	draw
troop		
publisher	cotton	Jew
tent	what	competition
dimension		
six	kill	iron
Christmas	others	your
speech	climb	lab
reinforce	both	
poem	museum	drama
holy	awful	suppose
cholesterol	discourse	throw
refugee	century	basic
future	community	survive
familiar	giant	
method	trend	half
audience	education	
burden	idea	poetry
tone		
over	adviser	
enormous	relationship	manufacturer
think	foot	national
aide	rely	gender
assistance	homeless	deliver
twenty	wind	provision
bit	depth	
desire		
crew	favorite	identify
explore	curious	heart
nurse		
willing	air	
previously		
four	capable	jury
evolution	advance	
fighting	drop	identity
transform	mine	corporation
Internet	heaven	
town	onto	audience
operation	pretend	story
spring	wait	war
leaf		
spiritual	beside	bond
funding	rapidly	
finding	smell	
feed		
directly	available	simple
perhaps	boy	
cast	twelve	flight
ah	include	freedom
medium	grow	sigh
clear	sophisticated	long-term
dominate		
toe	notion	
female		
ticket	rate	blade
consumer	coal	
locate	intensity	fact
lower	apartment	relation
number	shoe	respond
painting	platform	interview
cultural	social	
realize	pine	
downtown	separate	fall
table		
external	chief	center
Soviet	fate	
ask	sacred	matter
engine	each	bring
old	interview	segment
somehow		
compete	resistance	southern
region	woman	
suffer		
real	immigration	floor
television	horror	
crowd	federal	aid
discuss	interpretation	
nor	brilliant	knowledge
assistant	screen	willing
mental	pregnancy	
knife	dealer	vulnerable
handful	selection	
communication	career	
fast	video	architect
literature	territory	body
possess	moral	
cool	owe	demand
complain	fifteen	tool
feel	perhaps	drop
found	pose	
floor	strength	index
art		
father	lead	gain
agree	satisfaction	temperature
personality		
stock	movement	name
equipment	allow	lost
remind	anyone	resemble
symptom	outcome	
two	decide	
urge	north	
economics	suggestion	those
creative	behind	
how	us	
ought		
province		
economist	guard	creature
thanks	coverage	intention
attribute	controversial	
moderate	country	dozen
event	layer	full
folk	take	certain
asleep	record	reference
relate	hero	
chip	worry	oppose
mere	correct	teaching
hot		
ago	mask	grow
rose	lab	
tongue	glad	bean
afford	wing	except
award		
loss		
insurance	hire	scale
aside	reading	
pour		
copy	control	
unique		
romantic		
beside	wisdom	
transformation	mark	
civil	membership	tremendous
terrible		
kick		
I	desert	committee
still	knock	recognition
define	function	let
cover	lake	evaluate
certain		
those	continue	nervous
enforcement		
skin	specifically	original
allow	food	
grocery	character	largely
shall	protect	force
talent	collapse	disorder
simply		
observe	high	opposition
anyone	previous	media
division	toward	
prison	frustration	
despite	legacy	
reason	shift	
piano	peace	
second	born	family
use		
German		
edition	technique	window
explosion	extensive	
palm		
trail	pay	state
dispute		
product	hour	expect
chapter	improvement	significant
widely	must	
stress	drag	shift
nod	train	
though		
prompt		
device		
eastern	adjust	phone
commercial	imagination	symbol
become	assistant	wife
confirm	they	stroke
basic		
treatment	degree	please
nation		
really	about	unique
load	bond	appoint
mainly	reduction	round
feature		
conservative	mouth	rid
then	director	slowly
true		
hour	wrap	
you	despite	
housing	sake	challenge
capital	flat	wing
love	limit	
steel		
competitor	moon	medication
function	share	
assessment	street	cow
empty	scientific	rarely
brother	safety	attempt
testimony	identification	milk
narrative	pride	flesh
give	employment	
observation	side	demonstrate
achievement	African	predict
invest	stability	
draw	expand	least
relative	eye	trial
yell		
welcome	AIDS	concept
hat		
fully	distribute	
setting	research	championship
increased	mm-hmm	lifetime
escape	spokesman	repeatedly
survivor		
slice	merely	morning
problem		
result		
along	activist	add
pose	during	
sand	report	
inform	better	try
chairman		
teach		
intensity	road	clearly
representative	regular	confront
last	dog	writing
plus	common	
electric	coffee	
precisely		
few		
conclusion	argue	salt
find	dinner	
move	response	reputation
turn	vote	refuse
absolute	material	determine
king		
create	meat	
ill	involvement	surface
running	sometimes	band
poor		
process	evolution	average
seize	hard	commission
boundary	vegetable	extra
lack	representative	defeat
key		
modern	occupy	
pregnant	in	
organic	boyfriend	
chief	convert	
guide	deck	infant
neighborhood		
air	procedure	
elsewhere	game	hell
fellow		
interesting	captain	appreciate
constitutional	shooting	progress
deep	democracy	theory
save	economist	factory
know		
never	shit	weapon
go	slowly	aide
camera	limited	shape
decide	regime	woman
judgment		
twelve	sleep	organization
portrait	reject	capability
yield	prove	management
south	depression	mistake
column		
official	master	how
defense	investigate	them
very	on	lifestyle
angle	opening	
Indian	world	concern
scholarship	thin	reality
vessel	would	contain
cite	command	
poetry	flavor	independence
photographer	delivery	
apart	central	hi
encourage	affect	dinner
pie	kind	physician
recover	bill	important
thin	horse	
trace	something	depression
structure		
left	sentence	student
production	all	
wire	city	well
bother	council	confidence
acquire	earnings	will
lap	deal	
exhibit		
climb		
Muslim		
vary	text	
attorney	instruction	
additional	Christian	bedroom
than	suit	
activity	drug	where
massive	tourist	
regime	depict	college
priority	upper	glove
vast	serve	staff
private		
pressure		
nice	sensitive	
farm		
wage	die	
illness	to	
leather	sample	picture
drop		
context		
dog	tunnel	mystery
muscle	concert	moment
best		
alone	smile	entire
biological	severe	
surround	highway	
accept	politics	traditional
mission		
jury	electric	player
passage	environmental	thus
clean		
shooting	shock	lady
angry	brother	report
egg	pollution	property
miracle		
why	live	
public	window	conviction
die	correspondent	business
incredible		
three	resort	observer
comment	domestic	restore
morning	briefly	Japanese
reflect	goal	just
hungry	themselves	additional
stare		
seven		
truly	six	guilty
aspect	medium	ally
invasion	instance	week
achieve	fair	
to		
variety	carefully	suffer
senior	exception	beyond
dress	future	standing
shirt	employer	effectively
call	nearby	they
generate	regarding	bet
memory	adolescent	near
captain	interest	wide
bear	minor	cable
tire	committee	market
undergo	hundred	
interpret		
his	height	crack
both		
community	factor	perhaps
guard	near	expensive
also	straight	experiment
besides		
spread	deficit	host
inside	ad	
civilian	still	data
facility	meter	desert
exact	transformation	association
changing	parking	downtown
imagine		
value	whereas	money
route	shake	basically
instance	phrase	you
deputy	stand	attribute
succeed	profile	African
controversial	himself	north
react	oven	
menu	dirty	quarterback
butter		
infection	traditional	lay
rapid		
of		
friendship	ideal	short
somewhat	container	school
ok	production	yours
porch	Catholic	available
million	dark	enhance
government	generally	classic
shrug		
kiss	factory	
more	similarly	territory
carefully		
bunch	pool	
area	literary	tension
phenomenon	license	analyze
wisdom	combination	reply
now		
fighter		
push		
late	stretch	
actress		
inner	chamber	tendency
throat	port	scholarship
rice	owner	pause
miss	pilot	chase
tactic	basketball	screen
above		
explode	might	
seat	garlic	
industry	exciting	dialogue
space	precisely	mental
wind	compose	yell
absolutely	independence	background
conclude	strengthen	
sport	somewhere	better
weapon	wage	platform
far	soon	letter
legislation	surely	heat
strategy	dramatic	rush
danger	attractive	consist
tour	historical	might
cookie	abroad	tradition
successfully	contact	grandfather
mouth	measurement	
percentage	tribe	
reporter	pain	there
vital		
prosecutor	possess	spending
brush	shrug	
proceed	assistance	ideal
armed	responsible	historian
string	citizen	represent
philosophy	constitute	king
fade	teaching	fear
five	attempt	
video	reputation	significantly
bottom	clue	PM
arrival		
PC	prior	
difficulty	relation	should
naturally	occasion	meet
southern	sick	compete
clock	furthermore	secretary
before	blood	vital
protein	treat	testimony
measure	house	locate
confront	table	result
engineering	confusion	go
remote	grass	handle
have	once	egg
telescope		
initially	psychology	culture
resident	prisoner	arrival
narrow	indication	criticism
multiple	ourselves	ride
else	again	environment
ultimately	trip	used
helpful	since	AIDS
hunter	visual	
consider	trail	deer
dialogue	if	associate
active	admit	criticize
food	float	shock
perfectly	care	
valley	sport	respect
chamber	find	tongue
vote	taste	
strip		
reader		
scared	style	
tonight		
schedule	above	
charge		
dead	pure	visit
coalition	region	department
expert	exact	
door	sink	specifically
reputation	publisher	supposed
dry	unlikely	entrance
birthday	hospital	
parking		
less		
substantial		
team		
abortion	willing	dead
quarter		
testify	ugly	
bell		
crop	Irish	bite
solid	exposure	prosecutor
environmental	appear	
word	largely	fabric
concert	tour	realize
legitimate	although	wrong
library		
gesture	pace	sample
tale	offense	primarily
sauce	incorporate	
destroy		
similarly	mechanism	arrange
attach	minute	
admit		
hunting	barrier	growing
tail	fan	extreme
photo	quarterback	
fill	folk	missile
once	rural	
ceiling	bone	landscape
hard	we	
clearly	index	
too	auto	worried
anticipate	spending	
pain	understanding	toward
expensive	own	Catholic
something	veteran	
necessary	avoid	win
attack	organization	safety
proud	clinical	snap
headline		
lake	troop	
killer	responsibility	
penalty	slide	champion
jacket	demand	carry
respondent	edition	belt
spot	media	forget
general		
priest	boom	manner
ball		
city	truly	dish
tap	hit	health
technology		
example	twin	president
target	object	accomplish
pack	southern	
person	victim	
rate	inform	
fifth	use	
gradually	admission	diversity
asset	biological	beginning
season	strange	
my	map	
time		
medicine	through	most
recall	discrimination	core
importance	lots	regulate
overcome	consume	tell
index		
so	however	anybody
resort	at	junior
common	floor	
learn	ie	bread
killing	exist	
alive	extremely	shirt
obtain	cigarette	
correct	along	
pile	national	below
acid	sale	passenger
desk	resolution	relief
idea		
wash	assume	each
each	acquire	whole
totally	manufacturer	
hit		
breakfast		
garlic		
scholar	grand	perspective
away	normally	
firm	technology	opposite
pant	destroy	majority
relief	pour	dismiss
Asian	reinforce	subject
etc	distribution	winter
brief		
furthermore	achievement	
struggle	mess	pale
cooking		
purpose		
paper	regional	bathroom
storage	little	article
African-American		
instrument	blade	feel
rating	benefit	
performance		
benefit	satisfy	
phrase		
mask	transportation	at
wide	public	enforcement
African	brain	
comparison	spend	frequent
rub	DNA	general
amazing	learn	yourself
blood	afraid	emphasis
illegal		
their	million	abroad
maybe	manufacturing	other
cut	land	previous
fact		
violate	competitive	species
naked	glass	effect
variable	cognitive	
thing	urge	jail
mostly		
carbon		
distribution		
original		
gap	youth	
separate	blame	
specialist		
plane	bathroom	good
zone	conclude	
young	mouse	west
roof	nuclear	itself
talk	tear	independent
divorce	arrangement	
quick	stomach	
psychological	baseball	smile
theme	regularly	occupy
delivery		
organization	meanwhile	prisoner
boat		
measurement	snow	
resist	expensive	French
language	problem	representative
nobody		
depending		
opposite	match	Islamic
drug	easily	intensity
continued	see	
personnel	preference	year
withdraw		
relax	heat	native
wet	rest	
technique	amount	stomach
bond	fairly	shall
summit	toy	award
link		
pop	route	wet
possible	okay	subsequent
hear	conservative	establish
student	fun	responsibility
secret	seven	breath
scenario	French	entertainment
him	attend	doctor
pause	normal	do
implement	treatment	Latin
federal		
cheese	silence	
sufficient	term	
uncle	personal	tour
bed	pair	Italian
opposition	may	pair
content	plate	hard
approval	sustain	park
drama		
chain		
ingredient	sister	aircraft
fit		
marriage	atmosphere	concrete
silver	acknowledge	produce
ordinary		
assumption	surprise	survivor
occasion	support	
condition	plenty	run
upper		
amount	cheek	stay
hypothesis		
recovery		
fence	for	
train	blind	
negative	part	camera
athletic	reduce	daily
iron	forth	memory
authority	belief	legislation
super	pet	
minister	efficiency	
thank	fish	star
lucky	fine	handful
engineer	bean	wild
command	expose	impact
identification	occupation	welcome
artist	healthy	depending
stretch	building	fit
kind		
contribution	honor	turn
rather	worried	privacy
democratic	numerous	creation
guideline	restaurant	
tear	terrible	little
reduction		
at	PC	obligation
belief	happen	network
scale	original	loss
pride		
courage	knowledge	
newspaper	keep	hotel
another	crew	cold
market	right	tower
subject	diverse	nomination
minority	stress	biological
within	scandal	
buyer	forest	
appropriate		
machine	vital	
era		
anybody	should	approximately
pocket	completely	
band		
tragedy	artist	
dealer	ticket	
grade	angry	plus
intelligence	cholesterol	need
belong	I	garage
mirror		
regulate	this	shake
drink	flee	tonight
slowly	authority	
belt	bake	middle
French	desire	presentation
Spanish	trust	arrangement
United	shout	sing
repeat		
anything	bird	bind
suicide	stranger	
shit	lawsuit	settle
cotton	professor	focus
adventure	tool	conclusion
ongoing	scheme	
pole	essentially	
absence		
edge	round	
assist	inspire	
detect	form	
she	you	scientific
nomination	channel	pot
capacity	anticipate	offense
following		
tradition	trick	pocket
closely	interpret	fourth
act	nomination	
class	child	fiber
enemy	company	stream
violence		
TV	net	distribution
work	garage	
lose	neither	sweep
dominant	attorney	marriage
effort	bus	build
convince		
plate	gay	ceiling
generally	principal	intense
normal	math	pipe
title	cool	
founder	frame	Supreme
comfort	surface	
wonder	him	contrast
around	where	
ethics	approve	
lifetime	story	
editor		
agricultural	lemon	practical
car	mission	totally
tend		
transfer	value	process
primary	science	
produce	band	nor
suppose		
almost	plant	permanent
yesterday	neck	
under	slice	flag
smooth		
rain	military	sit
director		
reduce	carry	
infant	discovery	alternative
designer		
extent	abuse	
supporter		
stake	distant	cloud
planning	pole	
distance		
conversation	stuff	grab
inflation		
homeless	working	
order	emission	institution
simple	role	software
fourth	among	label
peace	news	peak
historian	detail	down
observer		
threaten	satellite	
vulnerable	writing	
police	entertainment	
rise		
tea	enable	visual
math		
investor	date	
see	mayor	eye
principal	adopt	coach
developing	shore	location
proper		
exceed		
great	performance	vessel
document	describe	digital
top	somehow	supporter
back		
long	episode	immediate
oppose	cow	
show		
score	more	
religious	propose	musician
nine	vision	
officer	adult	complex
approach	definitely	exercise
against	civilian	square
between	island	defensive
mood	work	finally
secretary	pressure	quality
line		
deficit		
boss	menu	situation
brand	associate	maintain
tired	machine	gallery
increase	lady	offensive
institutional		
Jew	bombing	earn
reference	detailed	preference
read	Internet	TV
complaint		
testing	summit	
formal		
end		
grant		
unit		
originally	deer	describe
defendant	population	desperate
me		
orientation	powerful	
beneath	explosion	
retire	funding	oh
surprise	lovely	rating
mean	fresh	Asian
truth	fault	submit
except	pop	
home	wall	guide
divide	engage	undergo
flame		
poet	testify	
medical	horizon	issue
may	transfer	politically
ethnic		
which		
basketball	modest	
clue	trouble	link
street		
financial	onion	mere
frustration	document	
image	cultural	now
someone	peak	late
star	progress	bother
arise	moreover	Christian
guess	yell	
tissue	fit	
lean	service	recover
sugar	directly	
glass	farm	include
anyway	solid	journalist
shop	speak	divorce
snow		
them	everyday	
garden	basically	reinforce
nuclear	class	close
national	modern	test
celebration		
advocate	amazing	
sake		
utility	rope	Mr
sound	basket	unlikely
cable		
properly	assess	
rapidly		
wrap	newspaper	respondent
treaty		
survey	bad	
engage	tent	engineer
post	manager	height
regularly	follow	
proportion	code	distinction
wing	marry	
meet		
currently	operating	
want	online	
yellow	poverty	conference
range	cloud	face
perspective		
company	guest	penalty
pull	walk	coat
climate		
foundation	concentration	
necessarily	rating	proof
frame	appointment	
examine	false	source
investment	job	
tight	advanced	
advertising	disorder	elderly
follow	retire	
safety		
sophisticated		
thought	grab	medium
candidate	consider	charge
whatever		
layer	institution	healthy
success		
substance	many	lean
painful	plane	map
just	believe	eager
field	narrow	suspect
employment	classroom	income
meaning	sad	owner
sector	topic	game
couple	that	etc
pound	string	lucky
enterprise	prevent	
chemical		
sight		
president	final	myself
volume	exhibit	selection
reaction	God	nut
expansion	virtually	substance
trend	gender	otherwise
per	advertising	conflict
reveal	mom	grand
growth	sexual	image
disaster	energy	can
arrive	impossible	definition
swear	such	accuse
dirt	position	
participation	fiction	
analyst	early	cry
source		
economy	sequence	educator
bar	wooden	
north	broken	wonderful
society	usual	evaluation
adult	settlement	
viewer	vast	Ms
soft	word	tea
previous		
associate		
gently	feeling	payment
branch		
craft	afternoon	
month	average	
code		
childhood	sky	conversation
express	gun	funding
career	association	
section	freedom	habit
plastic		
glove	formula	clinic
judge	put	muscle
represent	senior	designer
need	manage	recognize
balance		
tournament	pitch	post
spin	alcohol	bowl
room	politician	rope
draft	educator	legend
personally	secretary	
background		
accident	sand	
can	only	
deeply	mood	interesting
baby	risk	several
suspect	advantage	
English	calculate	folk
author	appeal	economist
could	boss	me
owe	stop	reasonable
presentation	eat	Republican
low		
male	forget	
frequently		
pretend	intellectual	
distinction	political	
association		
neck	ice	teach
height	health	pink
near	imagine	pursue
next	waste	
therapy	cast	thousand
stranger	friendly	DNA
myself	helicopter	common
or		
terrorist	nice	
everything	impressive	
degree		
popular	much	man
property	race	
fear	mail	daughter
weak	charge	
with	contract	resist
during	battle	satisfy
cow	plastic	incredible
enough	chairman	
valuable		
about	justice	standard
contract	single	
they	wise	
deny		
board	so	thing
galaxy	pile	
ski	prison	
hotel		
definitely	grain	avoid
tourist	engineer	three
fun	throw	injury
guarantee	adapt	street
illustrate	overall	presence
subsequent	save	
characterize	self	if
slightly	give	swear
chart		
yes	quiet	intellectual
advice	orientation	margin
particular	enforcement	evidence
expose	concrete	form
everyone	obtain	ticket
port	surround	
destruction	desk	page
highway	funeral	plan
promise	wake	bullet
stomach	recognition	provide
literary	liberal	
adjust	between	
humor	against	ensure
emission	beneath	
grain	application	
taxpayer	tendency	comparison
variation		
soil		
disability		
bring	produce	illness
restriction	passion	potato
demonstrate	wound	construct
focus	killing	sometimes
internal	significantly	competitive
issue	warning	concentrate
button	widely	laugh
pace	American	
lemon	Mexican	follow
cheap	boot	official
small	poem	principal
American		
war	versus	could
conference		
stable	lover	guy
raise	failure	
shadow	unit	opening
unlike	interaction	distribute
defend	third	
reality		
large	actual	transfer
settlement	buy	
theory		
aid	specialist	financial
false	good	
participate	accuse	latter
distribute	under	finding
overall	rush	juice
tower	body	actual
terms	planet	illustrate
some	everyone	mass
nearly	assignment	menu
court	living	
visual	grandmother	stand
slide		
reservation	religion	beauty
eye		
dependent	situation	new
notion	strongly	deserve
various	universe	
coach	rule	legitimate
prime	can	implication
partly	gas	darkness
manufacturing	refer	barely
hair	enhance	possible
replace	relative	
radio	yet	kind
meanwhile	yard	birth
mom	architect	
political	emphasize	liberal
dark	subsequent	
license	closely	hungry
story	tongue	chemical
beautiful		
unfortunately	lung	high
whole	connect	bury
hurt	cross	celebrity
tax	exceed	
extension	democratic	chip
say	involved	
action	range	help
concentration	lifestyle	commander
admission	Canadian	
tank		
duty	translate	qualify
promote	reason	warn
gain	sorry	
qualify	into	electric
evening		
finance	assert	
role		
symbol		
middle	species	exactly
devote		
surface	colonial	
smart	existing	
being	two	
consumption	engine	between
photograph	purpose	instruction
feeling	lunch	investment
preparation		
sky	field	glance
witness		
tip	odd	venture
matter	key	traffic
bank		
sin	operation	sugar
fee		
main	invest	bell
delay	painting	treat
resource	around	solve
disagree	helpful	illegal
architect	reader	who
complicated	clear	
mystery		
incentive	resource	person
guilty	insurance	examine
pink	evaluate	cost
depict		
study	begin	
regular	recruit	gate
crack	snap	
grand	summer	system
stair	bedroom	Democrat
Mrs	secure	sake
fly	ongoing	and
heavy	sharp	sea
breast	fuel	yesterday
exist	root	sport
cause	preparation	consider
imply	remove	photograph
wealthy	present	
due	end	
age	portray	butter
recognize	myself	artist
nervous		
pepper	cold	symptom
wealth	humor	widely
confidence	tower	
minute	vs	
account	bottle	painful
bury	consequence	
grass	terrorism	doubt
core	necessarily	friendly
justice		
flavor	thus	sure
position	absolute	branch
consideration	mother	
Latin	electronic	expansion
sales	potential	summer
travel	patch	impress
customer	presidential	given
odd		
equally	forever	tale
classroom	sudden	display
powder		
fair	legitimate	learning
merely	flower	substantial
council	state	above
country	arrive	
declare	elderly	ignore
container	orange	but
shot	tea	philosophy
visible	wide	young
abandon		
anxiety	bend	clean
predict	internal	kill
rich		
increasingly		
below	pan	gas
usual	trade	instrument
tie	actor	secure
European	clothing	administrator
village		
cheek	highly	captain
cognitive	expectation	God
this		
expectation	brown	proper
exhibition	way	
only	movie	insurance
darkness	upon	fishing
itself	positive	evening
composition		
tree	familiar	dare
citizen	maintain	tough
cluster		
flower	deny	significance
voter		
health		
strong	fellow	
afraid	go	forth
material	obligation	
glance	explore	perfectly
attend	agent	
note	charity	minority
definition		
steal	toe	computer
stone	juice	believe
seek	warn	
beyond	cat	scheme
celebrity	music	golden
series		
landscape		
encounter	treaty	basket
mother	strong	baseball
reach	alternative	insight
gay	activity	bottle
impression		
convention	bed	
Israeli	gesture	football
suit	difficulty	script
notice	developing	
poll	chase	resident
workshop	select	
trouble	intention	
gene	plan	
headquarters	habit	concert
store	chance	drink
anniversary	accident	
punishment	source	gay
eat		
magazine	adequate	surprising
introduce		
legend	fly	
file	external	teenager
better		
sanction		
conduct	singer	
page	insight	
analyze		
rural	dig	
investigator	naturally	jump
relation	percentage	
tobacco	money	extraordinary
funny	expansion	successfully
expand	bench	genetic
bus	main	adapt
ice	insist	beer
army		
apparent	profit	discrimination
independence		
politically	drive	lie
Republican	encounter	valley
path	possibility	
appear		
population	opponent	
gentleman	deeply	permit
completely		
discourse	post	must
publish	nearly	
habit		
sacred	conversation	top
natural	long	
ready	trace	size
root	mention	dramatically
weight	county	
concern		
virtue		
corn	wet	distant
capable	moment	taxpayer
user	history	cut
color	employ	
herself	tournament	strong
complex	emerge	opinion
such		
list	pass	power
none	path	
innocent	gear	probably
circumstance	consideration	
writing	deliver	
burn		
local	government	accurate
as		
parent	hotel	
earth		
advanced	individual	mountain
rank	impression	volunteer
athlete	mind	fifteen
stir	quit	
addition	impress	assessment
elementary	past	flame
alter	do	unable
specifically		
possibly	colleague	
broken		
hello	lift	academic
peak		
rest		
friend	buyer	Senate
press		
upon	instructor	leave
waste	device	founder
length	feature	deny
plan	frequently	
ship	push	save
justify	make	sensitive
staff	project	
campaign	editor	multiple
finally	old	priority
light	catch	decrease
trip	nobody	involved
family	continued	individual
run	physician	fully
strategic	winter	vacation
CEO		
shoulder	dust	maybe
option	reality	
personal	dry	director
one	brand	upon
God	Jew	six
online	fruit	
difference	rock	print
lesson	life	horse
severe	medicine	
spend	instead	rifle
producer	champion	snow
ignore	coat	assumption
regulation	leaf	
mm-hmm	couch	
shore	successful	
serious	airport	
acknowledge	wipe	apart
until	listen	operating
please		
through	publish	theater
auto	transition	
intense	fifty	
ghost	honest	perceive
likely		
operator	yellow	
entire	framework	happy
choice	resident	
sensitive	devote	shout
shelter	incident	fitness
cross	fighting	exception
for	how	
involve	than	strategy
affair		
negotiation	intelligence	
budget	wrong	succeed
bombing	refugee	
environment	recommendation	
salary		
pale	international	
objective	flame	fair
resolution		
eventually		
patient	certainly	
emotion		
soul	violation	
unusual	volunteer	percentage
confident	possible	horror
garage	substance	detail
straight	break	ready
diversity	eight	escape
circle	rail	rate
pan	blue	galaxy
constitute	gentleman	remarkable
business	tax	steal
scientific	odds	
sign	whether	
criticize	hear	
temperature	CEO	victory
by	shut	
impact	per	mother
scope	pocket	contemporary
proof		
hill		
no	girlfriend	
here	really	skill
wife	description	commitment
worry		
member	successfully	democratic
question		
pine		
smoke	household	mom
pair		
legal	circle	justice
instruction	scholar	acquire
advantage	slightly	following
billion	experience	
service	view	manage
clinic	second	
dad	fashion	British
sense	event	Palestinian
metal	succeed	everyone
league	gaze	sir
famous	British	artistic
minor	seat	suggest
extreme	literature	
border	officer	free
typical		
behavior	camp	define
pick	sanction	plant
impossible	square	favorite
rhythm	requirement	
the	door	occur
satisfaction	squeeze	anticipate
physician		
translate	weapon	my
sustain		
wonderful	roll	seem
sexual	huge	then
sale	contribute	silence
short	unless	difficulty
if	Muslim	
other	portrait	along
faith	leave	
historic		
bedroom	stupid	machine
beginning	battery	driver
congressional	volume	
bomb	electricity	
shock	equipment	involve
item	celebrate	politics
otherwise	Indian	pressure
begin	elite	register
cigarette		
net		
spokesman	border	democracy
fight	latter	Russian
versus	album	deck
traditional	obviously	tear
school	stroke	value
crime	press	
cat	kiss	often
teen	respect	roll
lead		
shake	purchase	
musician	create	
aim		
foreign	cover	
leader		
apply	criteria	evolve
proposed		
normally	gallery	incentive
blow	pause	via
sure		
beat	choice	fashion
estimate	smart	he
assignment	bar	
describe		
aggressive	chain	sale
happy	enter	exceed
sun	etc	brick
awareness	Senate	
threat	joy	
indeed	shape	so
launch		
convert		
horse	paint	ear
coast	extent	less
high		
majority	come	appropriate
marry	specific	
whereas		
challenge	ground	initiative
hi	shot	resolve
competition	apparent	truck
article	bomb	
management	meal	smooth
side	nod	
avoid	championship	heavily
professional	spring	protein
assume	half	word
vegetable	call	room
habitat	edge	suicide
milk	remember	consciousness
sea	grave	chapter
manner	complete	storage
knock	draw	relate
demonstration	star	uniform
fuel	dramatically	river
British	Palestinian	what
university	rose	
conviction		
trade	aside	
river	time	eight
chase	start	son
white	guy	
hire	baby	
development	Arab	last
Islamic	by	item
enter	nonetheless	
model	totally	community
law		
evolve		
rail	hot	literature
camp	league	experience
race		
lie		
goal		
teacher	river	
phone	indicate	
poverty	voter	singer
commission		
typically		
interested	daily	another
able	increasingly	
distant		
regard	birthday	arm
repeatedly	respondent	
unknown	pray	recent
request		
mountain		
AM	chef	likely
fish		
prisoner	Congress	
should		
interview	prospect	noise
highlight	journal	someone
historical	arrival	
damage	sign	necessarily
privacy	speed	adopt
tube	newly	nature
dance	contemporary	flee
moment	justify	greatest
quietly	scholarship	check
individual		
carry	football	
tell	seek	bad
bottle	phenomenon	
limit	conviction	end
off	bank	
numerous	relax	survey
different	awareness	
certainly	truth	chest
respond	fully	
connection	corner	with
hero	statistics	chef
display		
listen	extreme	
whom	sir	council
horizon	prescription	
impress	Ms	
pure		
sink	funny	possibility
assure	criminal	
bench	worker	executive
universe	below	stick
either	tonight	
money	silent	category
football	enterprise	celebrate
combination	king	
Mr	consumer	partnership
fundamental	dad	formula
essential	distinction	
towards	diversity	single
coffee	absence	
wear	throughout	among
tunnel	big	
plant	somewhat	plane
bend	organic	
singer		
chair	landscape	conduct
partnership	origin	radical
operate	Supreme	
brown	dress	weekend
fifteen	program	reaction
negotiate		
Russian	measure	election
mouse	according	
kitchen	priest	refer
mutual	various	United
proposal	surprisingly	judgment
today	sex	
smile	illegal	curriculum
hundred		
ten	fifth	European
scream	confidence	
category	bury	
responsibility		
analysis	anyway	trust
attractive	investment	
researcher	policy	equally
grandfather		
understanding	point	
whisper		
concrete	question	wedding
wait	remote	physical
live	quickly	improvement
soccer	missile	his
attitude	nowhere	
examination	via	interpretation
break	boat	identification
prescription	office	administration
application		
several	category	diverse
toy	potentially	any
cook	wealthy	teacher
dare	east	
laugh	heavy	sign
mount	unable	quit
nothing	these	tree
painter	guideline	preparation
wooden	capacity	overcome
stupid		
drag	beyond	quietly
host	experiment	stable
okay	visible	say
actually	particularly	participation
profit	cup	
heritage	tall	activist
neither	drawing	term
department	could	
gear	especially	
reject	relief	elite
concerned	global	intend
fault		
close	swim	
quote	anxiety	
living	lip	
liberal	constitutional	mall
foot	real	much
announce	admire	it
progress	extra	shit
politics	task	
respect		
theater	faith	
quality	budget	surround
lovely	birth	again
barrel	eager	flower
satisfy		
what	submit	
identify		
difficult	relate	
adolescent	Iraqi	
row		
everyday	bell	
seriously	recovery	auto
n't	tradition	remote
beauty	joke	lake
enable	understand	conclude
beach	draft	imply
badly	require	stuff
status	typically	portrait
segment		
detail		
criticism	install	pour
basis	combine	hot
bike	play	
blame		
wake	power	
survival		
eight	illness	carrier
slight		
game	quite	
coverage	analyze	mouse
yeah	hide	
vs	leader	wash
sorry	entrance	highly
thinking	investor	apple
fire	partner	
capability	regulation	future
emotional		
ugly	offensive	eliminate
ear	shoulder	whom
positive	cabinet	repeat
task	injury	call
people	bind	terrorist
period	message	sleep
immediate	twenty	ghost
champion	judge	color
restore	e-mail	
elite	perfect	rapidly
land	salt	leg
joke	suffer	procedure
primarily	best	title
ad	cause	hello
closer	market	
recording		
involvement	efficient	
thick	far	expression
yard	saving	organic
decline	quality	sell
luck	guilty	
corporate	travel	moon
deliver	assure	celebration
improvement	promote	
win		
others	lap	sequence
regarding	convince	highlight
site	let	
remove	set	
let	professional	program
label	gold	sense
fruit	rice	border
sit	victory	literary
package	somebody	on
address	family	shelter
fortune	throat	agenda
preference	coalition	direct
airport	narrative	
in	sigh	slip
whenever		
persuade		
expense	moderate	
monitor	union	
reasonable	unfortunately	rough
bad	primary	mask
attempt	incredible	relevant
disappear		
agent	proportion	bill
client		
improve	skill	
recipe	theory	knock
gold		
immediately	ease	
husband	because	statement
formation	suddenly	perfect
exciting		
behind		
transition	direction	special
shine	bet	assign
paint	card	stir
origin	delay	abuse
twin	wood	ability
collect	copy	performance
abroad	mad	
instructor	mountain	welfare
surgery	beach	
design	label	
forth		
happen	space	forever
square	tired	see
capture		
medication		
steady	employee	
particularly		
earn	major	
book	distinguish	nowhere
start		
share	next	mm-hmm
potentially	light	somebody
heel	privacy	thirty
representation	accompany	
restaurant	small	extent
guy	beautiful	found
media	night	yellow
technical	split	elsewhere
add	raw	imagination
traffic	mix	sauce
energy	ignore	voice
northern	kid	album
kid	same	punishment
yourself	handful	
cup	strike	shoulder
bone	or	newly
accuse	management	
secure	district	emergency
crisis	computer	
deck		
point	rather	climb
discussion	anger	absorb
whose	nor	refugee
all	substantial	
employ	evaluation	judge
provide		
mode	achieve	loan
consequence	certain	device
educational		
newly	advocate	
us	guess	
episode		
register	frequent	yes
anywhere	enjoy	transformation
pool	check	generally
therefore	raise	second
manager	digital	troop
honest		
freeze	temperature	explore
central	build	strip
set		
critical	commander	
tendency	urban	roof
search	dear	contact
laboratory		
onion	tell	conservative
doubt	signal	clue
red	jury	entirely
refer	craft	
scientist		
leave		
mail	repeat	presidential
crucial	software	helpful
initial	down	
welfare	qualify	exciting
margin	explode	prospect
message	express	profile
psychology	short	
support		
tribe	wander	line
lawyer		
prefer	analysis	argue
principle	restriction	
former		
district	participant	cabin
presence	element	tragedy
group	shelter	skin
establishment	legend	
peer		
leading	predict	
not	any	crash
water	yours	Canadian
custom		
already	imply	
dozen		
Jewish		
resolve	development	time
like		
experiment	freeze	group
independent		
procedure	brush	support
tape	heritage	intervention
publicly	south	book
meeting		
exactly	young	explosion
gun		
failure	radio	
relationship	act	battery
hand	late	
indicate		
maker	ten	
deserve	please	case
championship	herself	easy
journey		
care	thanks	
construct	quarter	
reply	universal	amazing
bread	female	
prevent		
novel	jet	representation
pleasure		
flesh	essential	during
session	scale	
sleep	picture	
initiative		
noise	nerve	
wine	speech	practice
location	quick	decision
stroke	business	protection
worried	gather	party
into		
stream	adventure	hit
get	wave	senator
emerge	tremendous	employer
shade	able	inspire
international	stare	hip
busy	operator	club
guest		
mad	athlete	
full	hold	
jet	chicken	adventure
intellectual	tie	directly
regardless	skin	dog
recommend		
deal	shop	
hearing	cash	
weigh		
prayer		
Palestinian	rise	library
lip	gray	
way	letter	speed
record	not	
artistic	slip	rice
boom		
greatest		
standing	important	heritage
forest	look	job
east	issue	
Bible	otherwise	birthday
salad		
ideal	initiative	ease
understand	slow	
academic	schedule	
breath	implement	educational
chance	invite	client
entrance	differently	friend
politician	destruction	tap
reading	magazine	
education	monitor	holy
outside	appoint	
day	regulate	way
Democrat	sit	
publication	free	one
gender	stream	German
enhance	user	ahead
genetic	struggle	
album	private	production
responsible		
permission	permanent	expose
send	comfortable	currently
fiber	title	rapid
jump	security	defense
however	handle	have
scheme	generate	participant
direct	well	
consist	my	building
settle	weak	pound
job	chapter	intelligence
neighbor	favor	possess
remember	gradually	miss
species	super	pool
trial	declare	measure
conflict	gate	either
pattern		
slip	figure	
fantasy	rough	specialist
consciousness	touch	athletic
sick	stage	around
wall	promise	
communicate		
channel	article	
urban	used	treaty
yet	partly	lift
criteria		
good		
payment		
themselves		
help	plus	
maintenance	symptom	author
controversy	minority	historical
forward		
silent		
implication	Republican	insist
cream	opposite	withdraw
dream	number	
abuse	earth	funeral
shortly	anywhere	direction
third	eastern	brilliant
throughout	debt	
seem	enough	lead
criminal	attach	
fishing	zone	fighter
union	jail	central
couch	itself	peer
odds	extraordinary	message
breathe	tissue	dealer
furniture	mere	service
ally		
mess	watch	own
determine	park	mount
same	instrument	cycle
head		
factor	comedy	technical
elderly	introduce	fail
trust	truck	connection
mark	armed	coffee
movie	likely	pepper
indication		
virtually	overlook	furthermore
creature	cite	emerge
cancer	wheel	four
county	works	actress
part	composition	foreign
leg	soil	frustration
correspondent	year	
provider	hardly	
wander	age	
democracy		
counter	aware	bend
fail	exhibition	
boot	general	lawsuit
teaching	fewer	sheet
enjoy		
quit		
concept	consumption	station
Japanese	register	newspaper
rid		
mass		
specific	Bible	union
dust	script	gentleman
differ	weekend	notion
always		
mine	labor	poll
swing	replace	lovely
fan		
lab		
compare		
juice		
strength	process	battle
wild		
basically		
meat	everything	
victory		
program	western	remove
power	appearance	design
it	effectively	planning
atmosphere	weight	look
clothing	worth	
warn	principle	reporter
solve	stable	nose
step	oil	pleasure
musical		
free	beer	pollution
nonetheless	classic	complaint
night	difference	scope
pregnancy	gently	apparent
ancient	confirm	
lay	priority	
organize		
switch	tough	region
manufacturer		
error		
shape	decade	
contest	never	
front	joint	Muslim
vacation	married	considerable
fund	dangerous	
spending	photo	ago
meal		
instead	across	information
Ms	clinic	
affect	disaster	enter
decade		
surprising	leadership	
maintain	abandon	urge
experience		
chef	sweep	vegetable
strange	initially	
tooth	inside	sorry
institution	obvious	
quite	get	
fabric	alter	classroom
must		
require	green	shell
storm	characteristic	feeling
birth	supply	slice
leadership	defend	resistance
do		
year	naked	child
when	proof	
inquiry	dance	
combine	powder	
out	crazy	spot
on	audience	up
baseball	commercial	
vision		
frequency	transform	tooth
solution	tap	
overlook	miracle	
potential	routine	global
among	wish	
essentially	concept	
surely		
labor		
element	mall	educate
effect	engineering	joint
week		
ratio	middle	
version	compare	
immigrant	entry	advance
according		
mechanism		
celebrate	telephone	feature
relatively	bright	land
clothes	survey	deputy
makeup	why	
knee		
character	arise	positive
view	hunting	
involved	originally	instead
appearance	miss	
wheel	perception	
weekend		
statistics	industry	extremely
roughly	even	investigate
any	grandfather	surprised
century		
suggest		
lock	diet	
Arab	every	recommendation
will	print	
defensive		
largely	motivation	motivation
special	warm	lack
stop	Mrs	alcohol
quiet	wire	code
classic	staff	
entry	habitat	fly
funeral	ethnic	characteristic
colonial	today	whose
relevant	agricultural	jet
join	ready	airline
usually	overcome	
form		
manage	pleasure	style
PM	sell	testing
virus	permit	busy
uniform	crime	ok
girlfriend	recognize	nearly
exception	egg	
park	man	inside
single	election	female
speed	library	hand
interest	solar	talent
junior	properly	collective
count	duty	alliance
profile	former	
sigh		
evaluation	crop	
carrier	condition	tip
nowhere		
successful	shopping	
depth	tone	after
essay		
incorporate	conventional	popular
depression	thinking	we
thirty	west	victim
military	carrier	wheel
exchange	downtown	sophisticated
new	suicide	recipe
used	toss	back
educate	observation	
eliminate	rapid	husband
level	reflection	marketing
joint	welfare	storm
shower		
battery	club	target
employer		
defeat	hand	
appreciate		
powerful	background	headline
emphasis	administrator	
professor	place	
missile	tire	
bullet	girl	
mind		
soon	seed	shooting
jail	piece	fighting
network	component	thin
hope	academic	afford
picture		
swim	aim	ancient
alliance		
actor	inquiry	lot
gray	represent	propose
drawing	agency	accident
match	settle	smart
cash		
stick	whatever	plenty
annual	fight	argument
corner	react	advise
although		
graduate	infection	
yours	reveal	ongoing
constantly	fear	
bathroom	attribute	
arrangement	ought	aggressive
since	away	care
shoot	tiny	grain
dismiss	design	
Chinese	threat	
believe	judgment	cooking
hold		
west	section	familiar
pipe		
retain	institutional	
insight		
every	challenge	coverage
emergency	concern	prison
bowl	sufficient	disagree
include	row	
gallery	testing	nothing
fresh	law	channel
finish	disappear	economics
murder	distinct	
potato		
flee	income	their
adviser	ski	fiction
extra	want	detect
teenager	garden	order
permanent	therapy	wisdom
complete		
lung	depending	
inspire	slight	
hall		
life	tip	soil
extensive	locate	
shell	wild	
exposure	me	including
arrest	shade	fuel
efficient	left	different
senator	change	
final	critic	live
even	vehicle	maker
operating		
recognition		
gift	hey	glass
answer	being	herself
rarely	morning	flavor
road	fundamental	
cold	provision	acknowledge
portion	up	mad
tremendous	cheese	death
fitness	English	
requirement	sheet	surgery
appointment	motor	debt
youth	involve	every
warning	village	
motivation		
round	her	
mistake		
huge	tomorrow	use
worth	area	
shopping	define	hour
strengthen	society	
assert	talent	
electronic	advice	
cop	top	nod
corporation	anything	plot
honey	telescope	score
hide	sense	
factory	criticize	
himself	art	
broad	clearly	solid
lover	minister	psychologist
soup		
golf	United	loud
rush	comparison	revenue
extraordinary		
treat	loose	sex
without	coach	operator
crash	player	completely
basket	ally	powerful
gaze